血祭2

按T後输入：

MPGOD =无敌
MPKFA =得到所有武器
MPAMMO =子弹全满
MPARMOR =护甲全满
MPCLIP =穿墙模式
MPPOS = 颢示位置
MPHEALTHY =生命值全满
MPWHEREAMI =显示座标
MPBEEFCAKE =增强力量
MPKILLEMALL =杀死所有怪物
MPSPEEDUP #=增加移动速度 (#= 1-5 )
MPSTRONGER # =增强力量 (#=1-5)
MPCALEB =转换角色为 Caleb
MPOPHELIA =转换角色为 Ophelia
MPISHMAEL =转换角色为 Ishmael
MPGABBY =转换角色为 Gabriella
MPGOSHOPPING =得到所有物品
MPNICENURSE =增加 25 点生命值
MPREALLYNICENURSE =增加 300 点生命值
MPWARD =增加 25 点装甲值
MPNEWCROWARD =增加 100 点护甲
MPTAKEOFFSHOES =隐形
MPHERKERMUR =杀伤力增加三倍
MPCARBONFIBER =增强心灵力量
MPCAMERA = 调整摄影机
MPLIGHTSCAPE = 调整光源
MPSUBMACHINEGUN =Submachinegun武器
MPFLAREGUN =Flaregun武器
MPSHOTGUN =Shotgun武器
MPSNIPERRIFLE =Sniper Rifle武器
MPHOWITZER =Howitzer武器
MPNAPALMCANNON =Napalm Cannon武器
MPSINGULARITY =Singularity Generator武器
MPASSAULTRIFLE =Assault Rifle武器
MPBUGBUSTER =Bug buster武器
MPMINIGUN =Minigun武器
MPLASERRIFLE =Cobalco Laser Rifle武器
MPTESLACANNON =Tesla Cannon武器
MPVOODOO =Voodoo Doll武器
MPTHEORB =The Orb武器
MPLIFELEECH =Life Leech武器
MPBEANSOFCOOLNESS = Gives a nice selection of weapons

